11111111111111111111111
100000C000000000C000001
1C000000000000C00000001
100000000C00000000000C1
10000001111111110000001
10000001000C00010000001
1C000001000E00010000001
100C00010010100100C0001
10000001C01010010000001
1000C001001010C10000001
100000011110111100C0001
10000000000000000000001
100000000C0000000C00001
11111111110001111111111
10000000000000000000001
10111111111111111111111
100000000C00000000000P1
11111111111111111111111
