1111111111111111111111111
1E00000000000000000000001
1000C000000000000000C0001
1000000001110011111100001
100000001111001111110C001
100000011011000C001100001
10000011001100000011C0001
1000011000110000001100001
1000110000110011111100001
100011111111001111110C001
1000000000110011C00000001
100000C000110011000000001
100000000011C0111111C0001
1000000000110011111100001
10C000000000C000000000001
100000C0000000000C0000P01
1111111111111111111111111
