1111111111
0000000001
1000000001
1000000001
1P0000C001
1E00000001
1111111111
