111111111
0P0000001
100000C01
1000E0001
111111111
