111111111
1P0000001
100C00C01
1000E0001
1111111
