11111111111
1000C0000C1
1E000900C01
1000C000001
11110001111
100C0000C01
1P000000001
11111111111
