111111111
100000001
1P0000001
10000C0C1
10E000001
111111111
	0011
	1
