111111111
1000000E1
100100001
1C0111111
11110C001
110000001
1000000P1
111111111
