111111111111
1E00100C00C1
10001000C001
100010C000C1
100010000C01
1111100C0001
100C00C000C1
10C00C00P0C1
111111111111
