1111111
10E0001
1E00001
1000E01
100C0P1
1010C01
1111111
