111111
1000P1
10P001
10P001
1E00C1
111111
