111111
100001
1P0001
110011
1000C1
111111
