1111111
1000001
1E00001
1C000C1
1000001
1111111
